6 2 2 2 2 2 2 2 2 1 2 2 2 2 2 2 2 2 2 7
4 10 10 10 1 1 1 1 1 1 1 1 1 1 1 1 10 10 10 5
4 10 10 10 1 1 1 10 1 1 1 1 10 1 1 1 10 10 10 5
4 10 10 10 1 1 1 1 1 1 1 1 1 1 1 1 10 10 10 5
4 1 1 1 1 1 1 1 1 1 1 1 1 1 1 1 1 1 1 5
4 1 1 1 1 10 1 1 1 1 1 1 1 1 10 1 1 1 1 6
4 1 1 1 1 1 1 1 1 1 1 1 1 1 1 1 1 1 1 1
4 1 1 1 1 10 1 1 1 1 1 1 1 1 10 1 1 1 1 6
4 1 1 1 1 1 1 1 1 1 1 1 1 1 1 1 1 1 1 5
4 1 1 1 1 1 1 10 1 1 1 1 10 1 1 1 1 1 1 5
4 1 1 1 1 1 1 1 1 1 1 1 1 1 1 1 1 1 1 5
4 10 10 10 1 1 1 1 1 1 1 1 1 1 1 1 10 10 10 5
4 10 10 10 1 1 1 1 1 1 1 1 1 1 1 1 10 10 10 5
4 10 10 10 1 1 1 1 1 1 1 1 1 1 1 1 10 10 10 5
8 3 3 3 3 3 3 3 3 3 3 3 3 3 3 3 3 3 3 9