6 2 2 2 2 2 2 2 2 2 1 1 2 2 2 2 2 2 2 7
4 1 11 11 1 1 1 1 10 1 1 10 1 10 10 1 1 1 1 5
4 1 11 1 11 1 1 11 1 1 1 1 1 1 1 1 11 1 10 5
4 1 11 1 1 11 1 10 10 1 1 1 11 1 1 1 11 1 11 5
4 1 1 10 1 10 11 10 11 10 10 1 11 1 1 1 1 1 1 5
4 1 1 10 1 1 1 1 1 11 1 10 10 10 1 1 1 1 1 5
4 1 1 11 1 1 1 1 1 10 11 1 10 1 11 10 10 10 1 5
4 10 1 10 1 1 1 1 10 1 1 1 1 11 10 11 11 1 1 1
4 1 1 1 10 10 10 1 11 1 11 1 10 1 1 11 11 10 1 1
4 10 11 1 1 1 1 1 1 1 11 1 1 11 1 10 1 1 10 5
4 1 1 1 10 11 1 10 1 1 11 1 1 11 1 1 1 10 1 5
4 1 1 1 1 1 1 1 11 1 10 1 10 1 11 10 1 1 1 5
4 1 10 1 1 1 1 1 11 1 1 11 1 11 10 10 1 10 1 5
4 1 1 10 11 1 1 10 11 11 1 11 1 1 11 1 1 1 1 5
8 3 3 3 3 3 3 3 3 3 3 3 3 3 3 3 3 3 3 9