2 3 3 3 3 3 3 3 3 3 3 3 3 3 3 3 3 3 3 4
12 10 10 10 13 1 1 1 1 1 13 10 13 10 10 1 13 13 1 14
12 1 1 1 1 1 1 1 1 10 1 1 1 1 1 13 1 10 1 14
12 10 1 13 1 1 1 1 13 1 1 1 10 1 10 10 1 10 1 14
12 1 1 10 10 1 1 1 1 1 1 1 1 13 1 10 13 1 13 14
12 13 13 1 1 13 1 1 1 1 1 10 1 13 1 1 10 1 1 14
12 1 13 1 1 13 13 1 13 1 1 13 10 1 1 1 1 1 1 14
12 1 1 10 1 13 1 10 1 1 1 13 13 1 10 1 1 1 1 14
12 1 1 1 1 1 1 10 10 10 13 1 1 13 1 10 13 10 1 14
12 1 1 10 1 10 13 1 13 1 1 13 1 1 1 1 1 1 1 14
12 10 1 1 1 1 13 1 10 1 1 1 1 1 10 13 1 1 1 14
12 1 1 1 10 1 13 10 1 1 1 1 1 10 1 1 13 1 1 14
12 1 1 10 1 1 13 1 1 1 1 10 1 1 13 1 10 1 1 14
12 1 1 1 10 10 1 1 1 1 1 1 1 1 1 1 1 1 1 14
22 23 23 23 23 23 23 23 23 23 23 23 23 23 23 23 23 23 23 24