2 3 3 3 3 3 3 3 3 1 3 3 3 3 3 3 3 3 3 4
12 10 10 10 1 1 1 1 1 1 1 1 1 1 1 1 10 10 10 14
12 10 10 10 1 1 1 13 1 1 1 1 13 1 1 1 10 10 10 14
12 10 10 10 1 1 1 1 1 1 1 1 1 1 1 1 10 10 10 14
12 1 1 1 1 1 1 1 1 1 1 1 1 1 1 1 1 1 1 14
12 1 1 1 1 13 1 1 1 1 1 1 1 1 13 1 1 1 1 14
12 1 1 1 1 1 1 1 1 1 1 1 1 1 1 1 1 1 1 1
12 1 1 1 1 13 1 1 1 1 1 1 1 1 13 1 1 1 1 14
12 1 1 1 1 1 1 1 1 1 1 1 1 1 1 1 1 1 1 14
12 1 1 1 1 1 1 13 1 1 1 1 13 1 1 1 1 1 1 14
12 1 1 1 1 1 1 1 1 1 1 1 1 1 1 1 1 1 1 14
12 10 10 10 1 1 1 1 1 1 1 1 1 1 1 1 10 10 10 14
12 10 10 10 1 1 1 1 1 1 1 1 1 1 1 1 10 10 10 14
12 10 10 10 1 1 1 1 1 1 1 1 1 1 1 1 10 10 10 14
22 23 23 23 23 23 23 23 23 23 23 23 23 23 23 23 23 23 23 24