6 2 2 2 2 2 2 2 2 2 2 2 2 2 2 2 2 2 2 6
4 7 7 7 1 1 1 1 1 1 1 1 1 1 1 1 7 7 7 5
4 7 7 7 1 1 1 6 1 1 1 1 6 1 1 1 7 7 7 5
4 7 7 7 1 1 1 1 1 1 1 1 1 1 1 1 7 7 7 5
4 1 1 1 1 1 1 1 1 1 1 1 1 1 1 1 1 1 1 5
4 1 1 1 1 6 1 1 1 1 1 1 1 1 6 1 1 1 1 5
4 1 1 6 1 1 1 1 1 1 1 1 1 1 1 1 6 1 1 5
4 1 1 1 1 6 1 1 1 1 1 1 1 1 6 1 1 1 1 5
4 1 1 1 1 1 1 1 1 1 1 1 1 1 1 1 1 1 1 5
4 1 1 1 1 1 1 6 1 1 1 1 6 1 1 1 1 1 1 5
4 1 1 1 1 1 1 1 1 1 1 1 1 1 1 1 1 1 1 5
4 7 7 7 7 7 1 1 1 1 1 1 1 1 7 7 7 7 7 5
4 7 7 7 7 7 1 1 1 1 1 1 1 1 7 7 7 7 7 5
4 7 7 7 7 7 1 1 1 1 1 1 1 1 7 7 7 7 7 5
6 3 3 3 3 3 3 3 3 3 3 3 3 3 3 3 3 3 3 6