6 2 2 2 2 2 2 2 2 2 2 2 2 2 2 2 2 2 2 6
4 8 8 8 1 1 1 1 1 1 1 1 1 1 1 1 8 8 8 5
4 8 8 8 1 1 1 7 1 1 1 1 7 1 1 1 8 8 8 5
4 8 8 8 1 1 1 1 1 1 1 1 1 1 1 1 8 8 8 5
4 1 1 1 1 1 1 1 1 1 1 1 1 1 1 1 1 1 1 5
4 1 1 1 1 7 1 1 1 1 1 1 1 1 7 1 1 1 1 5
4 1 1 7 1 1 1 1 1 1 1 1 1 1 1 1 7 1 1 5
4 1 1 1 1 7 1 1 1 1 1 1 1 1 7 1 1 1 1 5
4 1 1 1 1 1 1 1 1 1 1 1 1 1 1 1 1 1 1 5
4 1 1 1 1 1 1 7 1 1 1 1 7 1 1 1 1 1 1 5
4 1 1 1 1 1 1 1 1 1 1 1 1 1 1 1 1 1 1 5
4 8 8 8 8 8 1 1 1 1 1 1 1 1 8 8 8 8 8 5
4 8 8 8 8 8 1 1 1 1 1 1 1 1 8 8 8 8 8 5
4 8 8 8 8 8 1 1 1 1 1 1 1 1 8 8 8 8 8 5
6 3 3 3 3 3 3 3 3 3 3 3 3 3 3 3 3 3 3 6